А - A
Б - B
В - V
Г - G
Д - D
Е - E
Ё - JO - СТАТИЧЕСКАЯ ВЕРСИЯ БУКВЫ, YO - ПОДВИЖНАЯ
Ж - ZH
З - Z
И - I
Й - J
К - K
Л - L
М - M
Н - N
О - O
П - P
Р - R
С - S
Т - T
У - U
Ф - F
Х - H
Ц - C
Ч - CH
Ш, щ - SH
Ъ, Ь - '
Ы - Y
Э - EE
Ю - YU
Я - YA
ПРОБЕЛ - space

Жест Й требует доработки, поскольку скелет руки строится неправильно. Однако строится он одинаково неправильно почти каждый раз, поэтому пока что его можно распознавать при таком скелете. 